###############################
#  #          #     ## #      #
# ## ### ### #### #  # # # ## #
#  ##  # ##   # # ##   #   #  #
##  ## #    #     ### ## ### ##
# # #    #  # ###  #  #  # #  #
# #  # ######## #####    # ## #
# #        ##      #####   ## #
#   ## ###  ## # ###   ### #  #
# # #                #   # #  #
###############################