#########
# #### ##
#########
## ######
# ####  #
#########
# ##### #
#########